 ______________
|\ ___________ /|
| |  /|,| |   | |
| | |,x,| |   | |
| | |,x,' |   | |
| | |,x   ,   | |
| | |/    |%==| |
| |    /] ,   | |
| |   [/ ()   | |
| |       |   | |
| |       |   | |
| |       |   | |
| |      ,'   | |
| |   ,'      | |
|_|,'_________|_|