 ______________
|\ ___________ /|
| |  _ _ _ _  | |
| | | | | | | | |
| | |-+-+-+-| | |
| | |-+-+-+-| | |
| | |_|_|_|_| | |
| |     ___   | |
| |    /__/   | |
| |   [%==] ()| |
| |         ||| |
| |   [1 9] ()| |
| |           | |
| |           | |
| |           | |
|_|___________|_|